datetime,open,high,low,close,openinterest,vol,amount,settlementprice,lastsettlementprice,closerange,settlerange
2013/3/15,4701,4845,4701,4828,68,130,6271300,4824,4760,68,64
2013/3/18,4800,4849,4800,4808,58,62,2989300,4821,4824,-16,-3
2013/3/19,4831,4831,4810,4818,100,72,3466000,4813,4821,-3,-8
2013/3/21,4836,4841,4830,4841,116,48,2320700,4834,4813,28,21
2013/3/22,4841,4854,4837,4854,162,68,3293700,4843,4834,20,9
2013/3/25,4874,4880,4862,4862,164,20,974300,4871,4843,19,28
2013/3/26,4876,4899,4863,4864,178,60,2923500,4872,4871,-7,1
2013/3/27,4864,4869,4842,4854,192,54,2623700,4858,4872,-18,-14
2013/3/28,4889,4889,4844,4851,182,48,2333300,4860,4858,-7,2
2013/3/29,4816,4826,4799,4822,184,62,2984700,4813,4860,-38,-47
2013/4/1,4818,4842,4801,4801,198,98,4723900,4820,4813,-12,7
2013/4/2,4813,4822,4813,4813,200,16,770700,4816,4820,-7,-4
2013/4/3,4800,4826,4797,4800,206,32,1536900,4802,4816,-16,-14
2013/4/8,4800,4808,4793,4802,218,28,1344800,4802,4802,0,0
2013/4/9,4820,4820,4800,4805,238,60,2885700,4809,4802,3,7
2013/4/10,4816,4816,4803,4811,240,14,673400,4809,4809,2,0
2013/4/11,4807,4812,4807,4812,252,24,1154300,4809,4809,3,0
2013/4/12,4819,4819,4803,4807,254,14,673500,4810,4809,-2,1
2013/4/15,4803,4803,4791,4798,242,206,9879000,4795,4810,-12,-15
2013/4/16,4790,4797,4771,4783,352,238,11387000,4784,4795,-12,-11
2013/4/17,4797,4815,4794,4794,328,106,5092700,4804,4784,10,20
2013/4/18,4812,4813,4796,4805,332,40,1922900,4807,4804,1,3
2013/4/19,4815,4825,4804,4804,350,100,4813800,4813,4807,-3,6
2013/4/22,4800,4800,4778,4778,356,86,4116900,4787,4813,-35,-26
2013/4/23,4778,4785,4772,4785,362,44,2103000,4779,4787,-2,-8
2013/4/24,4770,4770,4731,4731,380,100,4742700,4742,4779,-48,-37
2013/4/25,4730,4731,4700,4700,384,154,7258700,4713,4742,-42,-29
2013/4/26,4720,4721,4690,4697,406,194,9134600,4708,4713,-16,-5
2013/5/2,4700,4715,4690,4699,440,116,5451200,4699,4708,-9,-9
2013/5/3,4711,4724,4708,4720,422,66,3112900,4716,4699,21,17
2013/5/6,4721,4750,4705,4750,438,72,3405100,4729,4716,34,13
2013/5/7,4727,4738,4727,4738,440,22,1041800,4735,4729,9,6
2013/5/8,4746,4756,4738,4751,438,20,940000,4749,4735,16,14
2013/5/9,4750,4750,4726,4726,428,78,3692100,4733,4749,-23,-16
2013/5/10,4735,4735,4699,4699,712,444,20891100,4705,4733,-34,-28
2013/5/13,4690,4690,4640,4640,878,324,15103300,4661,4705,-65,-44
2013/5/14,4648,4648,4608,4612,1138,672,31088000,4626,4661,-49,-35
2013/5/15,4622,4645,4614,4644,1202,340,15726200,4625,4626,18,-1
2013/5/16,4625,4670,4625,4668,1178,152,7063900,4647,4625,43,22
2013/5/17,4680,4703,4676,4703,1118,354,16604000,4690,4647,56,43
2013/5/20,4705,4747,4705,4715,1168,660,31193800,4726,4690,25,36
2013/5/21,4719,4719,4690,4690,1184,74,3483700,4707,4726,-36,-19
2013/5/22,4704,4704,4685,4696,1170,42,1972600,4696,4707,-11,-11
2013/5/23,4709,4709,4688,4688,1182,40,1880700,4701,4696,-8,5
2013/5/24,4680,4681,4659,4659,1276,188,8771700,4665,4701,-42,-36
2013/5/27,4660,4667,4641,4656,1302,88,4102000,4661,4665,-9,-4
2013/5/28,4662,4662,4652,4658,1370,76,3539700,4657,4661,-3,-4
2013/5/29,4658,4692,4658,4669,1448,414,19333000,4669,4657,12,12
2013/5/30,4665,4666,4651,4663,1456,74,3448400,4659,4669,-6,-10
2013/5/31,4671,4671,4656,4663,1464,44,2050600,4660,4659,4,1
2013/6/3,4685,4701,4682,4701,1366,192,9014900,4695,4660,41,35
2013/6/4,4690,4701,4687,4688,1372,38,1782900,4691,4695,-7,-4
2013/6/5,4697,4700,4690,4696,1354,46,2150000,4695,4691,5,4
2013/6/6,4681,4696,4680,4690,1304,72,3374500,4686,4695,-5,-9
2013/6/7,4699,4707,4681,4688,1318,30,1407700,4692,4686,2,6
2013/6/13,4681,4681,4666,4668,1320,44,2056200,4673,4692,-24,-19
2013/6/14,4665,4680,4665,4669,1338,44,2056100,4672,4673,-4,-1
2013/6/17,4665,4675,4656,4674,1324,44,2053200,4666,4672,2,-6
2013/6/18,4681,4685,4670,4679,1326,24,1122900,4678,4666,13,12
2013/6/19,4679,4679,4667,4667,1310,78,3645800,4674,4678,-11,-4
2013/6/20,4668,4672,4661,4661,1308,46,2147500,4668,4674,-13,-6
2013/6/21,4650,4660,4629,4629,1326,68,3154500,4638,4668,-39,-30
2013/6/24,4621,4632,4615,4618,1358,136,6286400,4622,4638,-20,-16
2013/6/25,4630,4645,4628,4645,1356,14,648700,4633,4622,23,11
2013/6/26,4645,4645,4630,4633,1452,108,5004700,4633,4633,0,0
2013/6/27,4534,4628,4534,4621,1458,60,2765400,4608,4633,-12,-25
2013/6/28,4622,4623,4613,4615,1454,46,2124300,4617,4608,7,9
2013/7/1,4600,4672,4578,4584,1494,188,8634500,4592,4617,-33,-25
2013/7/2,4589,4600,4589,4600,1546,124,5697200,4594,4592,8,2
2013/7/3,4594,4612,4594,4608,1544,36,1657600,4604,4594,14,10
2013/7/4,4612,4620,4612,4614,1546,26,1200300,4616,4604,10,12
2013/7/5,4636,4636,4619,4623,1548,16,740100,4625,4616,7,9
2013/7/8,4610,4611,4601,4601,1548,44,2027500,4607,4625,-24,-18
2013/7/9,4617,4635,4617,4624,1518,98,4535600,4628,4607,17,21
2013/7/10,4639,4639,4629,4635,1532,38,1760200,4631,4628,7,3
2013/7/11,4632,4645,4632,4636,1530,56,2595600,4635,4631,5,4
2013/7/12,4638,4641,4630,4630,1488,82,3804000,4638,4635,-5,3
2013/7/15,4615,4619,4611,4611,1500,42,1937400,4612,4638,-27,-26
2013/7/16,4613,4631,4613,4631,1498,72,3326300,4619,4612,19,7
2013/7/17,4626,4640,4626,4630,1514,104,4820800,4635,4619,11,16
2013/7/18,4630,4630,4600,4610,1700,320,14740300,4606,4635,-25,-29
2013/7/19,4608,4608,4557,4557,2004,992,45477500,4584,4606,-49,-22
2013/7/22,4550,4567,4537,4547,2010,268,12191800,4549,4584,-37,-35
2013/7/23,4560,4577,4555,4576,2002,154,7029400,4564,4549,27,15
2013/7/24,4555,4564,4547,4563,1962,142,6471200,4557,4564,-1,-7
2013/7/25,4551,4553,4491,4498,2452,1238,55893900,4514,4557,-59,-43
2013/7/26,4490,4490,4334,4334,2660,824,36210500,4394,4514,-180,-120
2013/7/29,4320,4330,4271,4286,3116,1768,75874900,4291,4394,-108,-103
2013/7/30,4301,4301,4223,4233,4106,2322,98574500,4245,4291,-58,-46
2013/7/31,4210,4305,4193,4300,3460,2172,92715500,4268,4245,55,23
2013/8/1,4280,4317,4277,4297,3468,830,35654200,4295,4268,29,27
2013/8/2,4279,4302,4267,4302,3530,560,24004000,4286,4295,7,-9
2013/8/5,4284,4299,4259,4284,3834,568,24275100,4273,4286,-2,-13
2013/8/6,4284,4285,4257,4263,4090,1610,68678800,4265,4273,-10,-8
2013/8/7,4250,4265,4195,4200,4966,1706,71863300,4212,4265,-65,-53
2013/8/8,4215,4237,4212,4214,5330,970,40931800,4219,4212,2,7
2013/8/9,4233,4235,4186,4192,6526,2612,109982200,4210,4219,-27,-9
2013/8/12,4192,4227,4191,4225,6906,1682,70875200,4213,4210,15,3
2013/8/13,4280,4285,4255,4272,6822,2168,92595000,4270,4213,59,57
2013/8/14,4263,4270,4228,4228,7708,1834,77882100,4246,4270,-42,-24
2013/8/15,4242,4262,4242,4249,8760,2264,96348100,4255,4246,3,9
2013/8/16,4276,4298,4257,4264,8974,2782,118857400,4272,4255,9,17
2013/8/19,4285,4296,4279,4282,8962,1478,63328700,4284,4272,10,12
2013/8/20,4330,4330,4271,4281,9634,2326,99678900,4285,4284,-3,1
2013/8/21,4279,4290,4276,4280,9778,866,37083700,4282,4285,-5,-3
2013/8/22,4278,4294,4278,4292,9594,1442,61796600,4285,4282,10,3
2013/8/23,4285,4296,4278,4285,9826,1124,48153800,4284,4285,0,-1
2013/8/26,4321,4445,4321,4430,9366,4124,181364800,4397,4284,146,113
2013/8/27,4424,4424,4375,4382,9564,1722,75554500,4387,4397,-15,-10
2013/8/28,4375,4395,4361,4367,9634,1844,80859000,4384,4387,-20,-3
2013/8/29,4379,4396,4336,4358,9876,1384,60417300,4365,4384,-26,-19
2013/8/30,4346,4354,4323,4327,9450,1776,77015200,4336,4365,-38,-29
2013/9/2,4331,4360,4331,4355,9400,1290,56101100,4348,4336,19,12
2013/9/3,4370,4372,4344,4368,9516,1252,54567200,4358,4348,20,10
2013/9/4,4351,4352,4332,4348,9680,446,19388300,4347,4358,-10,-11
2013/9/5,4350,4354,4340,4344,9736,708,30766400,4345,4347,-3,-2
2013/9/6,4344,4361,4336,4361,10042,844,36734700,4352,4345,16,7
2013/9/9,4362,4369,4356,4368,10198,976,42600500,4364,4352,16,12
2013/9/10,4344,4358,4341,4353,9958,876,38114200,4350,4364,-11,-14
2013/9/11,4357,4389,4353,4387,9966,1614,70524400,4369,4350,37,19
2013/9/12,4376,4406,4374,4395,10004,1008,44277500,4392,4369,26,23
2013/9/13,4425,4438,4406,4410,10174,1692,74665300,4412,4392,18,20
2013/9/16,4380,4390,4368,4368,10592,1520,66561400,4379,4412,-44,-33
2013/9/17,4360,4384,4355,4367,11754,2166,94565400,4365,4379,-12,-14
2013/9/18,4362,4389,4362,4385,11604,1094,47905800,4378,4365,20,13
2013/9/23,4350,4383,4347,4379,11706,2220,97123800,4374,4378,1,-4
2013/9/24,4384,4409,4378,4408,12520,2212,97140900,4391,4374,34,17
2013/9/25,4410,4418,4397,4407,12630,1106,48701100,4403,4391,16,12
2013/9/26,4410,4414,4396,4405,12838,906,39890600,4402,4403,2,-1
2013/9/27,4403,4403,4383,4393,12898,2334,102507100,4391,4402,-9,-11
2013/9/30,4390,4413,4377,4404,13218,1448,63756900,4403,4391,13,12
2013/10/8,4405,4433,4405,4428,13238,1744,77080900,4419,4403,25,16
2013/10/9,4419,4439,4415,4437,14058,1726,76408700,4426,4419,18,7
2013/10/10,4444,4475,4437,4467,17026,10180,454192300,4461,4426,41,35
2013/10/11,4466,4481,4448,4450,17632,2518,112407100,4464,4461,-11,3
2013/10/14,4462,4473,4440,4459,17988,2578,114927500,4458,4464,-5,-6
2013/10/15,4457,4470,4451,4457,18294,1718,76639900,4460,4458,-1,2
2013/10/16,4458,4495,4458,4485,21872,8806,394751500,4482,4460,25,22
2013/10/17,4492,4499,4461,4470,22288,4148,185763300,4478,4482,-12,-4
2013/10/18,4482,4490,4473,4483,22444,2266,101551800,4481,4478,5,3
2013/10/21,4486,4497,4480,4493,22394,6092,273596800,4491,4481,12,10
2013/10/22,4494,4498,4466,4467,22070,3748,168005200,4482,4491,-24,-9
2013/10/23,4465,4480,4450,4471,20868,4350,194334900,4467,4482,-11,-15
2013/10/24,4471,4492,4440,4449,23082,5834,260008700,4456,4467,-18,-11
2013/10/25,4440,4465,4433,4446,21116,11360,505921200,4453,4456,-10,-3
2013/10/28,4444,4447,4424,4431,22058,2490,110584900,4441,4453,-22,-12
2013/10/29,4423,4426,4392,4403,22034,3468,152850200,4407,4441,-38,-34
2013/10/30,4407,4422,4400,4407,22202,1530,67477600,4410,4407,0,3
2013/10/31,4412,4430,4396,4424,22360,2206,97545300,4421,4410,14,11
2013/11/1,4418,4453,4416,4438,22816,2930,130042600,4438,4421,17,17
2013/11/4,4422,4429,4418,4424,22202,3004,132864900,4422,4438,-14,-16
2013/11/5,4426,4441,4414,4431,21956,2154,95447400,4431,4422,9,9
2013/11/6,4421,4434,4413,4413,22078,2006,88705900,4422,4431,-18,-9
2013/11/7,4414,4435,4408,4434,22068,2226,98502500,4425,4422,12,3
2013/11/8,4436,4445,4425,4436,21920,2670,118447200,4436,4425,11,11
2013/11/11,4462,4478,4441,4455,21870,4476,199529400,4457,4436,19,21
2013/11/12,4459,4465,4440,4449,21730,2004,89184500,4450,4457,-8,-7
2013/11/13,4458,4458,4449,4451,21844,1394,62103300,4455,4450,1,5
2013/11/14,4452,4462,4448,4461,22000,1702,75861800,4457,4455,6,2
2013/11/15,4457,4466,4450,4450,21828,2348,104675000,4458,4457,-7,1
2013/11/18,4458,4458,4422,4424,21540,4862,215404200,4430,4458,-34,-28
2013/11/19,4428,4438,4397,4398,21278,6068,267559900,4409,4430,-32,-21
2013/11/20,4401,4401,4371,4383,22810,7370,322804600,4379,4409,-26,-30
2013/11/21,4377,4383,4357,4362,24764,7570,330519000,4366,4379,-17,-13
2013/11/22,4380,4380,4361,4368,25224,4504,196830400,4370,4366,2,4
2013/11/25,4383,4388,4340,4340,26908,8488,370248000,4362,4370,-30,-8
2013/11/26,4344,4352,4315,4318,28278,5886,255072400,4333,4362,-44,-29
2013/11/27,4317,4338,4317,4323,30762,7438,321879000,4327,4333,-10,-6
2013/11/28,4311,4314,4282,4285,34968,13034,559566600,4293,4327,-42,-34
2013/11/29,4294,4304,4285,4290,37242,7352,315548700,4292,4293,-3,-1
2013/12/2,4296,4320,4296,4313,39670,12268,529115600,4312,4292,21,20
2013/12/3,4307,4326,4296,4321,38868,8628,372504500,4317,4312,9,5
2013/12/4,4320,4331,4320,4326,39942,5994,259199300,4324,4317,9,7
2013/12/5,4331,4340,4325,4328,39982,4992,216226500,4331,4324,4,7
2013/12/6,4331,4334,4314,4319,39794,5278,228098500,4321,4331,-12,-10
2013/12/9,4322,4355,4318,4351,40232,9056,392669300,4336,4321,30,15
2013/12/10,4352,4359,4301,4342,41678,7864,341422100,4341,4336,6,5
2013/12/11,4341,4346,4335,4346,41758,2116,91842100,4340,4341,5,-1
2013/12/12,4346,4360,4332,4343,42238,9376,407046300,4341,4340,3,1
2013/12/13,4334,4363,4331,4345,42422,12950,563310300,4349,4341,4,8
2013/12/16,4350,4418,4349,4398,49954,24170,1061871200,4393,4349,49,44
2013/12/17,4412,4435,4398,4407,51246,18388,811885600,4415,4393,14,22
2013/12/18,4410,4419,4379,4388,52834,9432,414264000,4392,4415,-27,-23
2013/12/19,4370,4407,4370,4399,53502,6482,285016400,4397,4392,7,5
2013/12/20,4406,4406,4382,4396,55484,9364,410950000,4388,4397,-1,-9
2013/12/23,4381,4414,4381,4406,55406,4204,185136800,4403,4388,18,15
2013/12/24,4400,4411,4376,4389,57160,14732,646351000,4387,4403,-14,-16
2013/12/25,4398,4398,4377,4388,57708,11228,492595600,4387,4387,1,0
2013/12/26,4397,4397,4377,4377,57920,5170,226548100,4381,4387,-10,-6
2013/12/27,4372,4392,4360,4383,58316,7072,309765100,4380,4381,2,-1
2013/12/30,4360,4363,4226,4296,84960,201832,8644445700,4282,4380,-84,-98
2013/12/31,4288,4325,4288,4321,79940,43956,1895813700,4312,4282,39,30
2014/1/2,4312,4328,4286,4322,79750,27710,1194784100,4311,4312,10,-1
2014/1/3,4292,4330,4292,4326,77098,18792,811175500,4316,4311,15,5
2014/1/6,4323,4341,4313,4334,75212,22442,972149100,4331,4316,18,15
2014/1/7,4337,4359,4324,4338,68690,23942,1038202400,4336,4331,7,5
2014/1/8,4348,4353,4301,4341,67564,27576,1192945900,4326,4336,5,-10
2014/1/9,4330,4396,4330,4369,69346,19520,851693200,4363,4326,43,37
2014/1/10,4368,4463,4364,4442,84478,78046,3454631300,4426,4363,79,63
2014/1/13,4440,4442,4383,4388,70772,42710,1878924300,4399,4426,-38,-27
2014/1/14,4401,4409,4383,4397,67394,14850,652430400,4393,4399,-2,-6
2014/1/15,4393,4428,4393,4420,67066,15006,662511100,4414,4393,27,21
2014/1/16,4425,4462,4407,4456,70948,25600,1136131000,4438,4414,42,24
2014/1/17,4447,4483,4440,4460,77404,31182,1389811700,4457,4438,22,19
2014/1/20,4455,4522,4443,4510,86694,47360,2127204400,4491,4457,53,34
2014/1/21,4510,4521,4485,4509,90834,39458,1778235000,4506,4491,18,15
2014/1/22,4484,4504,4459,4471,90682,38928,1744019100,4480,4506,-35,-26
2014/1/23,4472,4503,4468,4475,90564,24560,1102053200,4487,4480,-5,7
2014/1/24,4466,4477,4437,4454,87602,27706,1233554100,4452,4487,-33,-35
2014/1/27,4468,4470,4451,4458,85750,11542,514520200,4457,4452,6,5
2014/1/28,4469,4469,4436,4440,81424,12508,555580200,4441,4457,-17,-16
2014/1/29,4440,4456,4433,4439,80110,7338,326025200,4442,4441,-2,1
2014/1/30,4435,4435,4401,4410,76986,13814,610671700,4420,4442,-32,-22
2014/2/7,4448,4480,4437,4462,77612,16214,723669400,4463,4420,42,43
2014/2/10,4462,4525,4459,4519,103744,65302,2937502100,4498,4463,56,35
2014/2/11,4527,4555,4500,4519,122190,87674,3973818100,4532,4498,21,34
2014/2/12,4530,4560,4523,4547,132898,42450,1930074800,4546,4532,15,14
2014/2/13,4535,4565,4531,4564,137238,34664,1577411300,4550,4546,18,4
2014/2/14,4580,4584,4547,4558,137314,26202,1195372400,4562,4550,8,12
2014/2/17,4558,4562,4524,4540,137362,30726,1395847800,4542,4562,-22,-20
2014/2/18,4543,4553,4511,4512,135608,31340,1419291100,4528,4542,-30,-14
2014/2/19,4530,4539,4477,4499,133362,52336,2356889000,4503,4528,-29,-25
2014/2/20,4496,4518,4493,4510,127620,36282,1635390000,4507,4503,7,4
2014/2/21,4515,4524,4484,4514,140296,67258,3032733600,4509,4507,7,2
2014/2/24,4519,4557,4505,4544,147572,67604,3065510700,4534,4509,35,25
2014/2/25,4544,4553,4524,4525,147326,37648,1708309700,4537,4534,-9,3
2014/2/26,4535,4544,4515,4520,146876,30500,1381024500,4527,4537,-17,-10
2014/2/27,4524,4534,4498,4505,147090,39176,1768221900,4513,4527,-22,-14
2014/2/28,4490,4490,4452,4453,147658,56384,2519758400,4468,4513,-60,-45
2014/3/3,4458,4484,4458,4470,149666,34982,1564641700,4472,4468,2,4
2014/3/4,4467,4470,4441,4456,147746,44604,1986216900,4453,4472,-16,-19
2014/3/5,4460,4488,4454,4482,149210,41364,1850077000,4472,4453,29,19
2014/3/6,4475,4485,4471,4474,149142,17794,796815700,4478,4472,2,6
2014/3/7,4483,4488,4453,4454,146216,44666,1995928100,4468,4478,-24,-10
2014/3/10,4451,4451,4319,4336,126596,143864,6283341800,4367,4468,-132,-101
2014/3/11,4314,4403,4300,4398,106786,67762,2964264400,4374,4367,31,7
2014/3/12,4374,4393,4369,4379,104896,33716,1476908700,4380,4374,5,6
2014/3/13,4377,4377,4345,4368,103528,45570,1984482200,4354,4380,-12,-26
2014/3/14,4367,4381,4356,4364,102108,30792,1345431400,4369,4354,10,15
2014/3/17,4360,4362,4340,4361,97640,26322,1145427200,4351,4369,-8,-18
2014/3/18,4362,4378,4345,4363,91658,30882,1346734300,4360,4351,12,9
2014/3/19,4373,4375,4359,4362,90950,20834,910018400,4367,4360,2,7
2014/3/20,4360,4362,4317,4341,90328,50208,2178417300,4338,4367,-26,-29
2014/3/21,4331,4351,4331,4340,89044,17018,738881400,4341,4338,2,3
2014/3/24,4340,4349,4324,4331,87668,13054,565869300,4334,4341,-10,-7
2014/3/25,4330,4353,4330,4336,82794,22702,986058500,4343,4334,2,9
2014/3/26,4335,4347,4311,4323,88152,33734,1458906200,4324,4343,-20,-19
2014/3/27,4325,4346,4304,4308,93632,39332,1700291000,4322,4324,-16,-2
2014/3/28,4304,4316,4284,4288,95248,34008,1462469500,4300,4322,-34,-22
2014/3/31,4277,4295,4257,4269,98798,34554,1477171300,4274,4300,-31,-26
2014/4/1,4278,4335,4278,4308,97212,61356,2644653700,4310,4274,34,36
2014/4/2,4310,4330,4267,4267,104238,56410,2421758800,4293,4310,-43,-17
2014/4/3,4266,4280,4241,4261,108792,48574,2070039400,4261,4293,-32,-32
2014/4/4,4266,4308,4252,4291,116646,76098,3263166900,4288,4261,30,27
2014/4/8,4280,4298,4275,4291,115082,34696,1487657700,4287,4288,3,-1
2014/4/9,4300,4326,4292,4297,115352,45548,1964367000,4312,4287,10,25
2014/4/10,4298,4316,4298,4299,115710,30730,1323526200,4306,4312,-13,-6
2014/4/11,4294,4302,4280,4288,120182,24574,1054211600,4289,4306,-18,-17
2014/4/14,4286,4369,4286,4358,132282,113064,4904767200,4338,4289,69,49
2014/4/15,4355,4380,4342,4365,143184,81514,3553517200,4359,4338,27,21
2014/4/16,4381,4386,4354,4371,143526,44306,1934489100,4366,4359,12,7
2014/4/17,4385,4395,4360,4391,150196,44932,1967007000,4377,4366,25,11
2014/4/18,4385,4421,4380,4396,174144,98294,4326113200,4401,4377,19,24
2014/4/21,4401,4408,4351,4351,183362,76516,3345340400,4372,4401,-50,-29
2014/4/22,4350,4371,4331,4363,180624,52470,2285025800,4354,4372,-9,-18
2014/4/23,4353,4376,4344,4358,179128,43224,1884406200,4359,4354,4,5
2014/4/24,4363,4392,4356,4391,182652,27248,1191153300,4371,4359,32,12
2014/4/25,4388,4462,4386,4445,202882,186828,8294301900,4439,4371,74,68
2014/4/28,4468,4481,4451,4471,216714,91282,4078802600,4468,4439,32,29
2014/4/29,4459,4508,4444,4499,239672,121262,5439346000,4485,4468,31,17
2014/4/30,4507,4522,4481,4485,240380,82214,3697977100,4497,4485,0,12
2014/5/5,4454,4488,4449,4472,240348,52362,2341724900,4472,4497,-25,-25
2014/5/6,4470,4470,4374,4377,276826,232432,10270185700,4418,4472,-95,-54
2014/5/7,4369,4387,4353,4359,282706,120258,5251561500,4366,4418,-59,-52
2014/5/8,4356,4405,4351,4381,284566,157604,6910663700,4384,4366,15,18
2014/5/9,4400,4402,4373,4376,274376,61304,2687978900,4384,4384,-8,0
2014/5/12,4385,4400,4371,4382,262468,74774,3279519700,4385,4384,-2,1
2014/5/13,4386,4450,4374,4448,273440,180466,7976669100,4420,4385,63,35
2014/5/14,4457,4515,4456,4510,299358,178446,8024991700,4497,4420,90,77
2014/5/15,4510,4565,4495,4538,303438,207598,9423951100,4539,4497,41,42
2014/5/16,4526,4560,4517,4552,300860,130274,5912840300,4538,4539,13,-1
2014/5/19,4550,4600,4518,4561,286900,145062,6612865200,4558,4538,23,20
2014/5/20,4567,4584,4524,4547,277002,183856,8369190500,4552,4558,-11,-6
2014/5/21,4545,4575,4504,4512,260496,228242,10340777800,4530,4552,-40,-22
2014/5/22,4530,4566,4513,4523,260432,168646,7653383300,4538,4530,-7,8
2014/5/23,4520,4549,4507,4518,258124,83792,3791104700,4524,4538,-20,-14
2014/5/26,4525,4535,4495,4507,254402,88742,4004600600,4512,4524,-17,-12
2014/5/27,4507,4529,4495,4517,245754,106052,4786235300,4513,4512,5,1
2014/5/28,4515,4604,4506,4572,247392,207236,9468612100,4568,4513,59,55
2014/5/29,4575,4584,4546,4548,243202,77392,3530946300,4562,4568,-20,-6
2014/5/30,4550,4574,4464,4502,232976,111002,5021706200,4523,4562,-60,-39
2014/6/3,4501,4521,4489,4516,226836,49754,2242867000,4507,4523,-7,-16
2014/6/4,4508,4530,4485,4490,222314,62830,2831268500,4506,4507,-17,-1
2014/6/5,4494,4500,4435,4439,217950,79782,3557906100,4459,4506,-67,-47
2014/6/6,4443,4444,4408,4437,207124,77626,3434694500,4424,4459,-22,-35
2014/6/9,4440,4475,4436,4466,196282,56870,2537207300,4461,4424,42,37
2014/6/10,4466,4483,4425,4426,188096,73052,3255420200,4456,4461,-35,-5
2014/6/11,4428,4447,4421,4425,185982,30246,1340509000,4432,4456,-31,-24
2014/6/12,4417,4448,4400,4436,182642,40658,1800527600,4428,4432,4,-4
2014/6/13,4418,4439,4410,4426,180436,25144,1113139300,4427,4428,-2,-1
2014/6/16,4427,4473,4427,4461,177294,33154,1476396400,4453,4427,34,26
2014/6/17,4460,4463,4432,4438,174774,32048,1423749600,4442,4453,-15,-11
2014/6/18,4430,4460,4421,4445,173858,24102,1071741100,4446,4442,3,4
2014/6/19,4441,4458,4441,4445,172574,10738,477959000,4451,4446,-1,5
2014/6/20,4451,4477,4448,4464,170774,32392,1445762800,4463,4451,13,12
2014/6/23,4475,4507,4472,4490,168908,24776,1112669000,4490,4463,27,27
2014/6/24,4484,4489,4458,4461,166052,20208,903635500,4471,4490,-29,-19
2014/6/25,4460,4470,4433,4438,166880,28172,1253534900,4449,4471,-33,-22
2014/6/26,4438,4446,4424,4428,166308,16338,723883100,4430,4449,-21,-19
2014/6/27,4440,4451,4420,4420,162930,19920,883634100,4435,4430,-10,5
2014/6/30,4408,4426,4397,4412,162378,14498,639944000,4414,4435,-23,-21
2014/7/1,4395,4395,4306,4334,161478,76288,3316211200,4346,4414,-80,-68
2014/7/2,4341,4354,4314,4337,161342,22486,974109300,4332,4346,-9,-14
2014/7/3,4320,4332,4302,4326,161950,10028,433420400,4322,4332,-6,-10
2014/7/4,4327,4327,4290,4290,160638,9468,407787700,4307,4322,-32,-15
2014/7/7,4293,4293,4261,4270,158766,15282,653170800,4274,4307,-37,-33
2014/7/8,4269,4340,4269,4323,155140,20858,899922900,4314,4274,49,40
2014/7/9,4303,4324,4272,4282,153612,12916,556070400,4305,4314,-32,-9
2014/7/10,4279,4289,4267,4273,145294,17502,748089300,4274,4305,-32,-31
2014/7/11,4269,4297,4252,4280,142190,12878,550105600,4271,4274,6,-3
2014/7/14,4256,4295,4240,4293,122368,34424,1469137300,4267,4271,22,-4
2014/7/15,4299,4312,4285,4293,117020,14328,615904000,4298,4267,26,31
2014/7/16,4297,4310,4293,4300,112974,11480,493999800,4303,4298,2,5
2014/7/17,4296,4312,4292,4295,108796,6598,283631700,4298,4303,-8,-5
2014/7/18,4297,4319,4285,4298,104978,7908,339775500,4296,4298,0,-2
2014/7/21,4280,4362,4276,4339,97088,23716,1028959000,4338,4296,43,42
2014/7/22,4336,4413,4334,4406,93216,36506,1605429200,4397,4338,68,59
2014/7/23,4400,4414,4391,4399,90760,16066,707269700,4402,4397,2,5
2014/7/24,4413,4422,4392,4397,90842,6702,294965600,4401,4402,-5,-1
2014/7/25,4399,4404,4392,4397,90304,3498,153779600,4396,4401,-4,-5
2014/7/28,4401,4453,4401,4447,91888,17822,791545000,4441,4396,51,45
2014/7/29,4453,4463,4444,4446,86238,13744,611571000,4449,4441,5,8
2014/7/30,4436,4447,4423,4447,84810,4192,186000500,4437,4449,-2,-12
2014/7/31,4435,4451,4435,4447,84716,5870,261099200,4448,4437,10,11
2014/8/1,4456,4456,4441,4452,82628,4504,200351300,4448,4448,4,0
2014/8/4,4448,4491,4448,4481,70964,30204,1350452400,4471,4448,33,23
2014/8/5,4488,4490,4463,4467,66180,14062,628668400,4470,4471,-4,-1
2014/8/6,4461,4474,4457,4457,63744,5920,264067100,4460,4470,-13,-10
2014/8/7,4468,4470,4441,4442,57452,8238,366531600,4449,4460,-18,-11
2014/8/8,4442,4460,4440,4449,55924,4340,193134300,4450,4449,0,1
2014/8/11,4452,4479,4446,4477,51188,18058,806703800,4467,4450,27,17
2014/8/12,4480,4480,4457,4457,49810,2566,114539000,4463,4467,-10,-4
2014/8/13,4456,4523,4456,4523,44470,9022,405566100,4495,4463,60,32
2014/8/14,4520,4564,4472,4501,42012,18522,836871400,4518,4495,6,23
2014/8/15,4512,4524,4494,4506,36776,6602,297170200,4501,4518,-12,-17
2014/8/18,4507,4507,4474,4497,35088,3736,167607300,4486,4501,-4,-15
2014/8/19,4489,4497,4443,4452,28896,11676,520507200,4457,4486,-34,-29
2014/8/20,4465,4467,4438,4464,27636,3240,144307900,4453,4457,7,-4
2014/8/21,4456,4459,4433,4442,25574,3930,174629400,4443,4453,-11,-10
2014/8/22,4453,4461,4449,4452,19868,8442,376091600,4455,4443,9,12
2014/8/25,4446,4468,4442,4468,18682,4184,186544500,4458,4455,13,3
2014/8/26,4468,4517,4460,4515,14256,8602,386267600,4490,4458,57,32
2014/8/27,4502,4520,4488,4497,13234,1398,62965400,4503,4490,7,13
2014/8/28,4478,4495,4464,4482,10986,5832,261136400,4477,4503,-21,-26
2014/8/29,4474,4499,4470,4480,8684,2468,110812100,4489,4477,3,12
2014/9/1,4460,4500,4460,4470,7544,1666,74484400,4470,4489,-19,-19
2014/9/2,4480,4590,4480,4506,4146,4700,210818800,4485,4470,36,15
2014/9/3,4555,4564,4555,4564,4146,2628,119829900,4559,4485,79,74
2014/9/4,4480,4551,4480,4551,244,1606,73080800,4550,4559,-8,-9
2014/9/5,4551,4551,4551,4551,0,244,11104500,4551,4550,1,1
